00000000000000000000
00000000001110000000
00001110000000000000
00000000000000000000
00000000111000000000
00000000000000000000
00000000000011100000
00000000000000000000
00000000000000000110
00000000000000000000
00000000000011100000
00000000000000000000
00000000000000000000
00000000000000000000
00000000000000000000
00000000001110000000
00000000000000000000