____________________
__________000_______
____000_____________
____________________
________000_________
____________________
____________000_____
____________________
_________________000
____________________
____________000_____
____________________
____________________
223______________122
556______________455
556______________455
556______________455
556______________455
55c22222222222222d55
55555555555555555555